######
#    #
### ##
#    #
#.####
######
