 ############### #####                   
#...............#.....#
#.#############.###.#.#
#.........#   #.....#
#.#######.#    #####
#.#...#...#
#.#.#.#.##
#...#.#...#
 ####.###.#
#.......#.#
#.#####.#.#
#.#...#.#.#
#.#.#.###.######
#.#.#.....#.....#
#.#.#####.#.###.##
#.#.#.....#...#...#
#.#.#####.###.###.## ###       ###
#.#.....#.#.#...#...#...#     #...#
#.#####.#.#.###.###.#.#.##   ##.#.#
#.#...#.#.....#.#.....#...# #...#.#
#.###.#.#####.#.###### ##.###.###.######
#.....#...#.#.#.#...#S#...#...#.#.#.....#
 ####.###.#.#.#.#.#.#.#.###.###.#.#.###.#
#.....#...#.#.#...#...#.#...#...#...#.#.#
#.#####.###.#.#########.#.#.#.#.#####.#.#
#.#   #...#...#.#.......#.#.#.#...#.#...#
#.#    ##.#.###.#.#######.#.#.###.#.#.##
        #.#...#.#...#.....#.#.#.....#...#
        #.###.#.###.#.#####.#.#########.#
        #.#.....#...#.#.....#.........#.#
        #.#####.#.###.#.#####.#######.#.#
        #...#...#.#...#.#.....#.....#...#
         ##.###.#.#####.#.#####.#.######
          #...#.#.......#.#.....#X#.....#
           ##.###########.#.###.###.###.#
            #.......#...#.#...#.......#.#
             ####.#.###.#.###.#########.#
              #...#.....#...#.#...#...#.#
              #.###########.###.#.#.#.#.#
              #.................#...#...#
               ################# ### ###
