################ #####
#...............#.....#
#.#############.###.#.##
#.........#   #.....#...#
#.#######.#    ########.#
#.#...#...#       #...#.#
#.#.#.#.##       ##.#.#.#
#...#.#...#     #...#.#.#
#####.###.#     #.###.#.#
#.......#.#     #.# #...#
#.#####.#.#     #.#  ###
#.#...#.#.#
#.#.#.###.######
#.#.#.....#.....#
#.#.#####.#.###.##
#.#.#.....#...#...#
#.#.#####.###.###.## ###       ###
#.#.....#.#.#...#...#...#     #...#
#.#####.#.#.###.###.#.#.##   ##.#.#
#.#...#.#.....#.#.....#...# #...#.#
#.###.#.#####.#.###### ##.###.###.######
#.....#...#.#.#.#...#S#...#...#.#.#.....#
#####.###.#.#.#.#.#.#.#.###.###.#.#.###.#
#.....#...#.#.#...#...#.#...#...#...#.#.#
#.#####.###.#.#########.#.#.#.#.#####.#.#
#.#...#...#...#.#.......#.#.#.#...#.#...#
#.###.###.#.###.#.#######.#.#.###.#.#.##
#.#.....#.#...#.#...#.....#.#.#.....#...#
#.#.###.#.###.#.###.#.#####.#.#########.#
#...#...#.#.....#...#.#.....#.........#.#
#####.###.#####.#.###.#.#####.#######.#.#
#...#...#...#...#.#...#.#.....#...  #...#
#.#####.###.###.#.#####.#.#####.#. #####
#.......#.#...#.#.......#.#    .#X#.....#
#.#######.###.###########.#   #.###.###.#
#.#.........#.......#   #.#   #.......#.#
#.#########.#####.#.#   #.##   ########.#
#.....#.....#.#...#..   #...# #...#...#.#
#####.#.###.#.#.###########.###.#.#.#.#.#
#.......#.....#.................#...#...#
######## ##### ################# ### ### 
