###########
#...S##..X#
#.######..#
#........##
###....####
###.#######
###########
